...###.#.... 
##.#...####.
...#.#.#....
#.####.####.
#F..#..#.##.
###.#....#S.
#.#.####.##.
....#.#...#.
.####.#.#.#.
........#...